--W----W-
W-B-WW--W
--W-W----
-W--W---B
---W--WB-
BBB-KW-BB
--BB---W-
----B-W--
----BB---